aabid	abida
aadesh	aayesha
aadil	anadi
aadish	hadisha
aaditya	aditya
aaenab	aamna
aaftaab	atta
aaftab	lata
aagad	aaradhana
aagand	gagan
aahim	aashi
aajad	faaija
aajiv	anaji
aakar	akbari
aakas	akash
aakash	aakanksha
aakib	abhaki
aakil	bakila
aalam	alam
aamil	aamina
aamin	aamrin
aamir	aasmin
aamod	paramdeep
aamosh	paramshela
aanad	aanya
aanand	nand
aanil	anil
aansu	aasu
aaqif	aarif
aarav	ajara
aarif	aarifa
aariv	aarti
aarti	aarati
aas	aasha
aash	aashia
aasha	aashma
aashif	aarushi
aashik	aashiya
aashis	ashish
aashish	kashish
aashu	aashu
aasif	aansi
aasim	aasma
aasish	kasish
aasto	aastha
aatam	mamata
aatif	arati
aatir	taravaati
aavesh	parvesh
aayush	aaysha
aazad	shahzadi
abbal	sabba
abbas	tabbasum
abdul	hasbul
abdulla	lila
abdullah	hasibullah
abhash	abha
abhay	bhagay
abhaysingh	hasina
abhi	abhilasha
abhijeet	bhim
abhijit	hini
abhilash	kailash
abhimanu	anu
abhimanyu	ashima
abhinandan	hina
abhinash	asha
abhinav	albina
abhinay	rabina
abhinwav	avi
abhiraj	hira
abhisek	mahi
abhisekh	shekh
abhishak	isha
abhishek	aishe
abhishekh	ishu
abhishiek	ishika
abhishik	shika
abid	ajnabi
abishak	aisha
abishek	alis
abrar	shabra
abu	khushabu
abul	pabu
achin	sachi
adalat	daulat
adan	chnada
adarsh	darkash
adersen	rena
adesh	aesha
adhish	mahvish
adi	adiba
adil	dilshadi
adisan	san
aditi	aditi
aditiya	diti
aditya	sadiya
adityalok	dibya
adnan	anandi
adrash	asho
aejaz	ajan
affan	afarin
afjal	ajmal
afridi	afrin
afsar	afsari
afshar	afsha
aftab	gulshafa
afzaj	fiza
afzal	kazal
agrej	kumarage
agyapad	daya
ahamad	alhamdi
ahmad	ashma
ahmed	mahender
ahsan	ahsamin
ahupendra	bhupendri
aidtya	alita
aijay	ajay
ajab	farhaja
ajad	sahaja
ajahar	har
ajaj	ajju
ajay	anjaly
ajaypal	jaya
ajeem	fareem
ajeet	endrajeet
ajim	ajima
ajit	ajmit
ajman	aman
ajmer	ajmeri
akaash	akansha
akansh	parkash
akash	meenakashi
akashya	ashiya
akbar	godambari
akeel	shakeela
akhalak	chandrakala
akheelesh	akhilesh
akhil	rakhila
akhilesh	iesha
akhileshwer	nilesh
akhlakh	kala
akhlaq	alkha
akhlesh	alkesh
akhlish	alish
akhtar	akhtari
akib	janaki
akif	kailaki
akil	sakila
akilesh	aleesha
akkash	ashu
akkni	rakki
akram	akram
akshat	raksha
akshay	akshita
akshit	sakshi
akshpaat	kesha
aktab	ankita
alam	salama
alamin	almina
alaudin	udi
albaksha	shma
ali	ali
alijan	amijan
alikhan	alisha
alim	dalima
allabaksh	kalla
allaraji	raj
allauddin	guddi
alok	alka
altab	lta
altaf	lalita
altmash	alma
aluddin	faimuddin
aman	amandeep
amandeep	mandeep
amar	amar
amarapal	manormapal
amarchand	archan
amardeep	deepa
amarendra	amarin
amarjeet	amanjeet
amarjit	amarjit
amarnath	nathi
amart	namarta
amarvesh	sarvesh
amba	amba
ameen	amreen
ameer	ameera
amil	jamila
amin	damini
amina	amina
amir	amiraka
amiri	amri
amit	mamita
amjad	ramjas
amjat	amrat
amkit	amita
amlesh	kamlesh
ammar	amari
amol	chhamo
amot	samoti
amratalal	lal
amreek	amreeta
amrik	amrik
amrika	ambika
amrish	amisha
amrit	amrit
amritpal	amrita
amrjeet	kamjeet
amrudin	amrin
amuchla	ramu
amzad	samsad
anamol	anam
anand	anandwati
anandi	nandi
anandu	nandu
anantram	anara
anash	anshu
anchal	anchal
andhav	sandha
angad	ganga
angan	kangana
angda	manda
angreg	anguri
anikesh	anisha
aniket	ankeet
anikt	aanik
anil	anjila
animesh	manish
anirudh	niru
anish	manisha
anita	anita
anjali	anjali
anjan	anjana
anjani	anjani
anjeev	sanjeev
anjrej	ajra
anjum	anjum
ankaj	pankaj
ankala	mangala
ankesh	ganeshi
ankit	ankit
ankur	mankuri
ankus	kanku
ankush	anushka
anli	manlisa
anmol	anno
annat	jannat
annu	annu
anoj	manoj
anokha	anekha
anooj	noojo
anoop	anoopama
ansal	anjal
ansar	anaro
ansh	anshika
anshu	anshul
anshul	priyanshu
anshum	kashum
anshuman	huma
ansu	ansu
ansul	farjanul
anubhav	manbhar
anuj	manuja
anup	anupam
anupam	anupama
anurag	anoura
anuraj	raja
anurudh	anuradha
anvar	anjara
anwar	anwari
anwari	bhanwari
aoosaf	aasa
aphasana	aphsana
arab	sarabjit
arajun	raju
araslan	arshla
aravind	ravinda
arbaj	ariba
arbaz	arbana
archna	archna
arfan	arifa
arham	farha
arhiyant	arshi
arif	aarifun
arindom	oma
arindra	harvindra
arjun	aarju
armaan	maan
arman	amana
arnab	arpna
arnabjit	paramjit
arpit	harprit
arsad	barsa
arsh	darshan
arshad	harsha
arti	arti
aru	aruna
arun	karuna
arunkumar	kum
arvind	parvinder
aryan	paryanka
asagar	asgari
asarfi	safia
asfak	asma
asfaq	sifa
asgar	asharani
asha	ashanjali
ashad	ashra
ashak	astha
asharam	rama
ashfaq	aysha
ashif	ashmi
ashik	sashikala
ashiqu	ashnu
ashish	kashis
ashishi	shrishti
ashiya	anshiya
ashlam	vashila
ashok	khasbhoo
ashraf	ashrabi
ashrfi	shri
ashshwer	shahera
ashsish	yashsvi
ashu	durgash
ashutosh	ashtha
ashwani	ashwani
ashwini	ashmin
asi	amasi
asif	batasi
asish	raisha
asiwani	aswani
aslam	mausam
asrf	alahbasri
asruddin	fasrun
asutosh	satosh
aswin	jaswinder
atanu	tanu
ateek	tek
atif	ajkati
atish	satish
atitaj	taj
atu	batul
atul	matul
avadh	vadhi
avdesh	dinesh
avdhesh	maheshar
avfesh	naresh
avinas	ravina
avinash	savina
avinsh	nainshi
avnish	tanisha
avnit	kavit
avtar	bavita
awdesh	sarwesh
awdhesh	dhaneshwari
awedhesh	maneesha
axat	aatikun
ayan	aayana
ayub	ayushi
ayube	juber
ayush	ayasha
azad	gulnaza
azam	nazama
azaruddin	hudi
azaz	shahnaza
azhar	gilbahar
azim	nazima
azruddin	nazrin
baam	badami
babalu	babali
baban	babita
babar	bhawar
babbu	babbu
babli	babli
babloo	batloon
bablu	babbli
babram	bsram
babu	banu
babudden	deena
babuddin	babbi
babul	bala
babulal	lali
babupuri	nupur
baburam	iram
baccha	aachal
bacche	bahalen
bacchu	bahnu
bachan	kachan
bachcha	machhala
bachheshwar	eshwari
bachhu	anchhi
bachu	panchu
bada	badarjahan
badal	bagdai
badan	bandana
badnath	amna
badri	badri
badrudeen	badru
badrulla	parul
badshya	bidhya
baga	bagga
bagaram	fara
baggusingh	guni
bagwan	bhagwan
bahadur	dur
bahart	bhart
bahrat	bharati
baichan	archana
baidnath	nathu
baijnath	alina
bajinder	rajinder
bajrang	basiran
bajrangi	rajrani
bajulal	balalia
baksi	saksi
bal	balbiri
balak	madhubala
balam	sasibala
balaram	bali
balbeer	baljeet
balbir	balti
balchand	chand
baldev	dev
baleshwar	baleshwari
baleshwer	kalpeshwari
baliram	baliya
baljeet	kamlajeet
baljinder	balvinder
balkishan	kishan
ballu	billu
balmiki	amie
balraj	raji
balram	shashibala
balveer	jasveer
balvinder	vinder
balwan	balwanti
balwant	bhagwanti
banarsi	arsi
bandu	bantu
bangali	gali
baniya	banita
banju	anju
bannu	bhanu
banshi	nanshi
bansi	mansi
bansilal	sila
banti	basnti
banty	bunty
banwari	bhanwar
banwarilal	sarla
bapu	papu
barham	barkha
barj	arjina
barjesh	brajesh
barjraj	rajl
barkat	barakha
basant	basanta
basanta	basanti
bashudev	bhudevi
basibul	nasibu
basir	nasir
baudi	papudi
bawan	bahwana
bechan	dhan
beekar	beena
beenu	meenu
beeram	beera
beeru	neeru
begraj	rajo
benay	beby
benu	beni
beragi	ragni
bhabhav	bhabhiya
bhaddal	dali
bhadur	bhura
bhag	bhaggo
bhagat	bhagvati
bhagipuri	bhagirathi
bhagirath	bharkah
bhagvaan	bhavana
bhagvati	bhagwati
bhagwan	bhagwani
bhagwana	bhawana
bhagwanaram	bhawani
bhagwat	bhagya
bhagwati	bhawari
bhahadur	durga
bhajan	jani
bhajandeep	deepu
bhajanlal	gajala
bhajju	haju
bhala	bhavna
bhalaram	hazara
bhan	bhanmati
bhani	bhakuni
bhanu	bhanumati
bhanvar	bhawna
bhanwar	bhanweri
bhanwer	bhateri
bharat	bharti
bharatlal	hazra
bharma	bharkha
bhart	simabharti
bhartendu	nadu
bhasker	sera
bhauk	bhanupriya
bhavesh	shalesh
bhavisaya	samya
bhavishy	hari
bhavishya	shiya
bhavuk	hazu
bhawan	hawa
bhawani	bhiwani
bheem	mobsheera
bheema	hema
bhemji	jai
bherav	heera
bhhatu	natu
bhikhari	bhiki
bhim	labbhi
bhima	bima
bhimsen	mena
bhisan	sana
bhismpal	bhopal
bhiva	bivla
bhojaram	jakra
bhojpal	bholi
bhola	dhola
bholaram	lada
bhole	phol
bholu	khushbhu
bhonu	bishnu
bhoop	khusbhoo
bhoopsingh	gopi
bhopal	gopal
bhorelal	bhori
bhotra	tara
bhram	bushra
bhramanand	mana
bhrat	bhatri
bhrkat	brkha
bhud	khubhu
bhudev	devi
bhudhashen	hena
bhudhi	bhundki
bhulaee	phul
bhulan	bhuli
bhuneshwar	keshar
bhup	khusbhu
bhupen	rupen
bhupendar	genda
bhupender	rupender
bhupendra	indra
bhupesh	bipnesh
bhura	bhuri
bhuralal	busra
bhure	hury
bhuri	hurji
bhusan	husana
bhushan	usha
bhuvneshwar	munesh
bhuwan	budhwanti
bidur	bindu
biitu	binita
bijander	jatinder
bijender	tejender
bijendra	binda
bikki	nikki
bikram	birma
bilal	bimla
bimlesh	bimlesh
binani	bina
bindu	binu
binja	bijali
binnu	binnu
binpal	dipa
bintu	mintu
bipin	vipin
bir	birmadevi
biraj	niraj
birajbhushan	shana
birajpal	kajal
biram	bidami
biran	bigan
birbal	iqra
birender	narender
birgesh	durgesh
birij	girija
birjesh	girjesh
birju	irtu
birpal	kirpa
biru	jasbir
bishan	ishrana
bishana	kishana
bishesh	isnesh
bishun	dishu
bisto	bitoo
bittan	tane
bitto	bitto
bittoo	bitona
bittu	nitu
bobbi	bobi
bobi	shabbi
boby	babby
bodh	bohati
bodu	khashbu
boduram	ugam
braham	radha
brahamprakash	prakshi
brahmanand	nanda
braj	charanjeet
brajendra	rajenderi
bram	birmati
brij	riju
brijesh	rajesh
brijlal	dila
brijmohan	mohan
brijnandan	brinda
brijpal	ranipal
brijshwaer	rishu
buddha	budho
buddhi	buchhi
budh	bushara
budhan	dhana
budhi	juhi
budhram	dhrama
budhu	deu
buhan	suhana
bulad	ladi
bulet	beti
bunda	sundga
bundel	belo
bundhu	indu
bunti	kunti
bunty	buity
bupal	rupal
busness	sneh
chabi	chhabi
chajju	charu
chakra	chandra
chaman	chaman
chamanlal	chama
champa	champa
chanchal	chanchal
chand	chanda
chanda	chandan
chandan	chandani
chandar	chander
chanden	chandni
chander	chanderkala
chanderbal	chanderkali
chandermani	mani
chanderpal	chanderpati
chandesh	chnda
chandeshwar	dhaneswar
chandi	chandini
chandki	chandkor
chandpreet	pree
chandra	chandracala
chandrashekhar	chando
chandreshwar	resham
chandrram	chandrika
chandru	chanderkanta
chandu	channu
charan	harana
charanjeet	charnjeet
charnjeet	harneet
chatan	chetan
chatar	bhatari
chaterpal	rampal
chaturbhuj	chahat
cheddi	chameli
cheete	tej
chela	shela
chertamani	mandi
chet	chetana
chetan	chetna
chetanram	hetal
chetanya	tanya
chetna	sucheta
chetram	chitra
chettan	ekta
chhabeel	shabreen
chhabil	chhavi
chhagan	chhagana
chhanoyar	chhano
chhantu	chhanya
chhatar	chhaterwati
chhedilal	diya
chhidu	chhoti
chhinderpal	depali
chhitar	chinta
chhotelal	choti
chhotu	chhotudevi
chiddu	rikkenchi
chinku	chinki
chintan	archita
chintu	pintu
chinu	rachnu
chirag	suchitra
chiranjavi	anja
chitprit	priti
chitra	chitro
chitrangan	ranjan
chitranjan	niranjan
chitu	minakchi
choga	gulpacha
chom	rencho
chootu	hoor
chorag	jhora
chosh	khooshboo
chotan	chotibai
chote	chotti
chotelal	kela
chottu	chuni
chotu	jhoti
chotum	uma
choturam	raman
chran	khanchan
chtar	akhatari
chtarpal	saral
chunaram	husnara
chunni	chunni
chunnu	jhunnu
chura	humera
daaud	dhapa
dabbu	tabbusum
dabu	chandabai
dakch	dhakha
daks	bindvasini
daksh	diksha
dakshina	darshna
dakshya	lakhya
dal	daljit
dalchand	kanchan
daler	arvinder
dalip	dipali
daljeet	manjeet
dalpat	dolat
dama	padama
daman	asman
damanjeet	taranjeet
damodar	mohd
dana	vandana
daniel	annielal
danveer	daveena
dara	indara
darshan	darshana
dasharath	ishrat
dashrath	shathi
dataterya	riya
dauad	anuja
dauji	fauji
davender	devender
davendra	devendri
davinder	ravinder
daya	dayavati
dayal	payal
dayaram	sayara
deba	jeba
deelip	deepali
deen	devideen
deendyal	deeya
deepa	deepak
deepaak	deepmala
deepak	deepka
deepali	deepanti
deepan	deepanshi
deepanker	panku
deepanshu	nishu
deepansu	sus
deepchand	chanab
deepender	indera
deepi	deepti
deepika	deepika
deepnarayan	naryani
deepu	sukhdeep
deepvhand	evan
deeraj	neeraj
deerendra	jeeren
deewan	jewa
denesh	deeksha
deni	nandni
depander	palvinder
desh	sudesh
deshraj	sira
dev	devanti
deva	devya
devanand	meva
devasheeh	varsh
devashish	rashi
devasish	seva
devdhari	vidha
devender	surender
devendr	devyani
devendra	inda
devesh	deepshikha
devi	devika
devid	devki
devik	devli
devilal	devkali
devinder	vinod
devindra	indta
devki	dhakhadevi
devkran	rani
devpal	dimpal
devraj	neraj
dhalchand	chango
dhamender	amena
dhan	aradhana
dhananjai	dhanni
dhananjay	sanjay
dhaney	dhaniya
dhani	ramdhani
dhanjay	hanja
dhanna	midhana
dhannu	dhapu
dhanpat	dhanpati
dhanraj	shanaj
dhansinghpuri	jhansi
dhanu	shanu
dhara	dharamvati
dharam	dharamveeri
dharambir	rambai
dharamender	harinder
dharampal	kamal
dharamveer	veera
dharamvir	prami
dharm	dharmshila
dharmandra	manira
dharmbir	karmi
dharmender	areen
dharmendera	namen
dharmendr	renu
dharmendra	nida
dharminder	raminder
dharmpal	pampa
dharmraj	amrta
dharmveer	veero
dharmvir	harmit
dharvesh	harshi
dhawal	dhanwanti
dheeraj	hemraj
dheerendra	heena
dhermendra	indira
dhiraj	hiri
dhirender	viren
dhirpal	irfa
dhiru	khairu
dhisa	disha
dhmendar	meena
dhram	yashdhra
dhrambir	rambiri
dhramender	fra
dhrampal	ramba
dhrampla	kamla
dhramveer	veeru
dhreej	harleen
dhrmveer	meera
dhruv	ruvi
dhukhu	sukh
dhulin	dholi
dhurav	shorav
dhurender	gurvinder
dhurpati	dropati
dhuruv	madhuri
dhurv	maadhuri
dhurve	turveny
dibakar	paka
digamber	mero
digvijay	vijay
dikshant	dilshana
dil	dilish
dilawar	ishawar
dilbar	gila
dildar	ilma
dilip	disi
diljan	fija
dilkush	dilkhush
dilsad	irsad
dilsah	snah
dilshad	vidisha
dilvar	divya
dimpal	vimal
dimpu	tipu
dimpy	rimpy
dineesh	neesha
dinesh	rinesh
dinkar	ikara
dipak	dipika
dipanshu	dipanshi
dipansu	diwansi
dipendra	jitendra
dipu	dipeeka
dirgaj	mira
disha	lisha
dishad	nisha
dishant	shanta
divaie	divy
divakar	saka
divansh	vasu
divaraj	itvarya
divy	bindiya
divyansh	dixya
diwakar	dwarika
diwan	siwani
dolat	foolmati
doodhnath	arthi
dord	dhodi
dorilal	doli
doulat	deou
dowlat	dolo
druga	durgabai
dukhi	ruhi
dulal	dulari
dular	rajdulari
dulichand	limca
dumnik	dumani
dund	badrunisha
duni	majidunisha
duraga	durgawati
durg	jaydurga
durga	surgayani
durgalal	gajla
durganand	uganta
durgashankar	shankar
durgesh	suresh
durgpal	rupa
durjan	puja
durvesh	urvashi
dushyant	shano
dwarika	dariya
dwarka	reka
dya	gudya
ebane	zeba
edris	gendi
ehasan	kehkasa
eklok	kallo
ekram	ekamjeet
eldro	dropti
eliyas	aliya
elwin	keli
emilia	mili
emran	hemani
esrail	rahil
etahsaam	sanam
ezaz	shenaz
fahim	fahija
faijal	faijina
faim	fatima
faimuddin	amuda
faisal	salu
faiyaaz	saiyada
faiz	fahira
faizal	fazia
faizan	farzana
faizudeen	fareen
faizur	fakiri
fakerey	rakhee
fakrrudeen	rubee
fakrudeen	fareena
fanni	manni
faqir	farah
faran	farana
farhan	farhana
farid	farida
farjand	farjana
farku	klu
farmaan	faraha
farman	manu
faroj	firoj
farukh	paru
fateh	ifteshyam
faujdar	suda
fazaley	aaliya
fazaz	farhanaz
fazulla	fauina
feru	jenifer
fhaishal	shalu
fharman	moharan
fida	firida
firakat	frra
firasat	irshrat
firoj	firoja
firoz	firoz
firtu	firdous
fitrat	sitra
fiyaz	safiya
forshan	roshan
fulmiya	fuli
furkan	ranu
furkhan	muskhan
gaffar	gayatri
gaffur	gaura
gafur	gauri
gagan	gyaan
gagandeep	sandeep
gahnshyam	nesha
gajender	tajinder
gajendra	gajana
gajraj	laja
galiya	haliya
galu	lalmuni
gandharv	sugandha
gandhi	nanhi
ganesh	ganesi
ganeshi	nenshi
ganga	gangajali
gangadhar	gango
gangaram	namra
ganpat	gyan
ganpati	atiq
ganpatram	nana
gantantra	ganita
gappu	gattu
garib	gargi
garsh	gyarsi
garupal	rupali
garv	bhgavti
gaurav	garima
gauravgil	lavi
gauri	gawri
gautam	satnam
gawali	nawali
geernish	geet
geesa	geeta
geeta	geetanjali
gensingh	nensi
ghan	meghana
ghanshayam	mansha
ghanshyam	hansa
ghansyam	asiya
ghantoli	santo
ghaseeta	seeta
ghasiram	hamsiran
gheesa	neesa
ghisaram	saira
ghurul	gul
girdhari	aktri
giri	girijarani
giriraj	gori
girish	girishchandra
girishi	sirish
girjesh	girja
girraj	sagira
girwer	joginder
givinda	govind
gjender	gendu
gladwin	ladu
gobind	bindi
gokul	goldy
goldi	goldan
goldy	doly
gollu	gouri
golu	koilu
gomti	gomati
gonsan	gona
goopi	angoori
gopal	gora
gopesh	lokesh
gopi	gotiya
gopiram	prya
gora	kushagra
gorav	gosia
gordhan	noorjhan
gordhanlal	radhadalal
goruav	ruka
gorv	ajnoor
gotam	sanjogta
gourav	gulran
gouri	gurmit
goutam	mota
goverdhan	versha
govind	jasvinder
govinda	jina
grish	risabh
gruchran	ruchi
guddu	guddo
gudiya	gudiya
gufraan	gulfara
gufran	frjana
gugna	gunja
gul	gulab
gulab	gulabsha
gulam	gulfsa
gulashan	gulafshan
gulfam	gulafsa
gulfan	guljan
guljar	gulnaj
gulreg	gulesta
gulshad	gulsha
gulshan	gulshan
gulsher	gulafsha
guluram	gulnaz
guman	suman
gunanidhi	nidhi
gur	gurdeep
gurbachan	rachana
gurbax	gulabsa
gurcharan	asrani
gurdarshan	sohan
gurdayal	gudia
gurdeep	gurjeet
gurfaan	gulfasa
gurjeet	gurmeet
gurjit	rita
gurlal	gulfsal
gurmeet	gurpreet
gurmit	riti
gurnam	punam
gurpreet	gurupreet
gurprit	ritu
gursimaran	sima
gurubaksh	gulbasha
gurucharan	rukhar
gurudut	guldasta
gurupreet	preet
guruvachan	chanpa
gurvinder	raghuvinder
gutam	sahgufta
gya	gyatri
gyan	subhagya
gyandeep	sandeepa
gyanender	nena
gyanendra	neni
gyanu	anuu
gyanwati	danwati
gyarsi	gyattri
habib	habiba
hadarali	ramli
haider	chanderwati
haji	shajiya
hajrat	hajrati
hakam	hagami
hakimuddin	halki
haliya	kaushaliya
halke	mithalesh
halkuji	ruji
hament	harmeet
hamid	hamida
hamza	karishama
handu	chandrawati
haneef	aneeta
hani	jahani
hanif	himani
hanish	shanichari
hanni	annavi
hanny	shanno
hanshraj	suraj
hansraj	maharaj
hanuman	anjuman
hanumanram	kumara
har	akthari
harak	harbai
hararat	sararwati
harbanschauhan	harbas
harbansh	taran
harbhajan	parbha
harbinder	rabin
harbir	manbharbai
hardam	sharda
hardas	sarda
hardass	rada
hardeep	navdeep
hardev	mahadevi
hardik	neharika
harees	harpreet
harender	pushpender
harendra	jharna
hareshwar	parmeshwari
hari	jhanjhariya
harib	manbhari
harichand	richa
haridutt	harjit
hariesh	shahrish
harikishan	pariksha
harimohan	mohani
harinarayan	rina
harinder	rinke
hariom	hamim
hariram	hazira
harish	nargish
harishankar	krishan
harishchandr	karishma
harishen	pari
harison	sona
harjeet	parmjeet
harji	manohari
harkesh	nargesh
harman	shama
harmani	dhamini
harnam	shabnam
harpal	subhapal
harprasad	saida
harpreet	grpreet
harshdeep	himanshee
harshit	harshita
harshmeet	meeta
harun	sharuna
harvans	shavani
harvansh	parvashi
harvinder	parvin
harwindra	sarin
hasan	asana
haseem	naseem
haseen	haseena
hashim	shashi
hashrat	sharshwati
hasibul	hasmi
hasim	nasim
hasina	asmina
hasir	shasi
hasrat	asmat
hassan	sano
hawa	ishawari
hayatul	hyatun
hazari	hajari
hazi	shazida
hazrat	azmira
heeera	sheela
heera	meeramai
heeralal	ladli
hema	hemanti
hemanshu	himanshu
hemant	hemlat
hemraj	iema
henkhochon	hongsi
hera	sumanthra
hifjul	juli
himal	shimala
himanshu	himanshi
himansu	himansi
himashu	rimasha
himmat	mamt
hira	mubshshira
hiralal	nirjala
hiramani	mangi
hisamuddin	mjudi
hisham	tisha
hiten	shiena
hitender	lakhvinder
hitesh	mitlesh
hitlar	shila
hom	ashman
homa	karshma
horam	shokraji
hosiyarilal	siya
hoti	moti
hrithik	ritika
hritik	kritika
hukam	shukla
hukamchand	shukramani
hukma	jhuma
hukum	kumud
husain	husainpreet
iarfan	irfan
ibarhim	rima
ibraham	nibha
ibraheem	faraheen
ibrahim	rahimun
idrish	shirishty
ijhar	nishar
ikbal	aanamika
iklakh	lakhe
ikramuddin	kamini
ikramudeen	kamreen
ikrar	iqrar
ilayat	layba
ilesh	mithilesh
ilyas	kailashi
imaman	imaman
imamuddin	nima
imamudeen	mahmun
imran	imrana
imsaan	muskaan
imtiaz	meti
imtiyaz	motiya
imtyaj	maya
imtyaz	mmta
inaam	sinaa
inayat	jinat
indal	jashinal
inder	inderjeet
inderjeet	inderjit
inderjit	jioty
indernath	indrvati
inderpaal	veerpal
inderpal	palak
indervesh	ramesh
indra	chndrakla
indraj	kulvinder
indresh	reshma
indu	minu
injmam	injum
inkoo	kohinoor
insaf	jainaf
iqarar	sitara
iqbal	khushnasiba
iqram	kiran
iqubal	rumal
irfan	kirann
irfhan	birtha
irphan	pano
irsad	sehrunisa
irshad	kirshna
ish	aishwarya
ishan	krishana
ishant	shanti
isharar	shaira
ishatkar	vishakha
ishtkar	ishita
ishu	vishnu
ishwar	rajeshwari
ishwari	swatri
ishwer	shweta
islam	nilam
islamuddin	nila
islamudin	samundri
israil	sahil
israr	nisa
isthar	sharmistha
istikar	isika
istkhar	nikkhar
istyak	pista
istyara	tyara
iswar	maheswari
iswer	mis
itwari	biwa
jaanu	jagan
jabbar	jubaira
jabir	jasvir
jacky	janky
jacob	jenab
jadu	kadu
jafar	jafrin
jaffar	jya
jafruddin	saru
jaga	joga
jagan	jugan
jagat	jagrti
jagbir	jagviri
jagdamba	jayda
jagdambika	ambiya
jagdeep	jamee
jagdeesh	meesh
jagdesh	manglesh
jagdiesh	jaishmin
jagdish	nargis
jagir	jahirul
jagjeet	japneet
jagjiwan	jaiwanti
jagmal	jaimala
jagmohan	mohni
jagnath	jaiguna
jagpati	jaimati
jagtar	gita
jahagir	sahar
jahgeer	saheen
jahid	janid
jahir	sahira
jahoor	noor
jai	jaimata
jaibhagwan	pawan
jaibir	jainab
jaichand	manchan
jaideep	jaismeen
jaidev	poojadevi
jaidul	amirul
jaijairam	rasmi
jainab	jainub
jaipal	jarina
jaiparkash	parkashi
jaiprakash	rakha
jaiprkesh	keshu
jairam	janam
jaisigh	jassi
jaiveer	avneet
jaivind	pavi
jakh	akhtri
jakir	janki
jalaluddin	jalma
jalil	pushpanjali
jalmi	rupanjali
jalsingh	asmin
jalwad	mala
jamaal	jamnaa
jamad	jamna
jamadar	jayada
jamal	ujama
jameer	jameela
jamil	pramil
jamir	jamrujaha
jamna	jamuna
jamshed	jasmen
janak	kanak
janardam	najda
janesh	javuneesha
janeshwar	neha
jang	gunjan
jani	rajani
jankidas	janvi
jankraj	januka
janmesh	mukesh
janta	kanta
jantarpal	santara
janwi	janwi
jaquir	jayuti
jarif	jarim
jarnail	jareena
jasbir	jasina
jasim	jaslin
jasiram	nasira
jaskaran	samra
jaskirat	kirti
jaspal	spna
jaspreet	jaspreet
jasvant	jaivanti
jasveen	jasleen
jasveer	tasveeran
jasvinder	javade
jasvindir	vidhi
jasvir	javitri
jaswant	asanti
jat	navjat
jatan	jaanki
jatin	jaioni
jauli	jashgul
javal	lavali
javed	samvedna
javid	junaid
jawahar	rajkanwar
jawhar	noorjahan
jayantadass	jayanti
jayesh	yogesh
jaykumar	kamar
jaynarayan	narayani
jayshing	sahin
jedu	jubeda
jeenat	jeenat
jeesan	jeevanlata
jeeshan	nazibuneesha
jeet	karamjeet
jeete	paramjeet
jeeth	simranjeet
jeetram	jeta
jeetu	geetu
jeevan	seeva
jeeya	ranjeeta
jetender	manjinder
jgdish	sohi
jhaban	shabana
jhagdoo	dhapoo
jhagdu	jhamaku
jhakar	shankarbhaya
jhalla	halima
jhawar	sahawaj
jigar	nigar
jile	hailena
jimi	bismilla
jimmi	rimmi
jisaan	saana
jisan	vaishanvi
jishan	joshna
jishant	jibanti
jism	ishmita
jisu	najis
jit	manjit
jitan	jaitun
jitander	satwander
jite	premjit
jitender	satwinder
jitendera	pritee
jitendr	jincy
jitendra	teena
jitesh	mithlesh
jitin	kristina
jittender	joity
jitu	ranjit
jiwan	gajwanti
jiya	jiya
jiyaul	joya
jockyipai	palvi
jodhi	joohi
jogender	benjeer
joginder	onginye
joholal	foola
jon	anjna
joni	sarojni
jony	joty
joria	jomiya
jorj	noorjaha
josin	jesmin
joydeep	joyate
jubed	julee
juber	juneb
jugal	jugani
jugender	sundri
juhewuddin	jhuhi
juhi	jhingi
julfi	muli
julficar	sufia
julfikaar	kajar
jumman	umma
jumrati	umrawti
junl	juna
junna	jhunna
justin	tina
juvel	jully
jwala	rajbala
jyoti	jyoti
kaari	kaarti
kabal	kawal
kabid	kali
kabir	satbir
kabul	kajul
kadir	mandira
kaif	kaifiya
kailash	kalashi
kailesh	kamlash
kaishav	keshav
kajamuddih	rajudi
kala	kaladevi
kalap	kalma
kalayan	kalyani
kaleem	tasleem
kaleram	alema
kali	anarkali
kalicharan	chaya
kalip	bahvarkali
kalish	kamli
kalla	kalpna
kallu	shallu
kaloo	shaloo
kalpadma	padma
kalpesh	laltesh
kalpna	kalpana
kalu	tinvkal
kalua	kamala
kaluram	karima
kalusingh	lushi
kalwant	kalwati
kalyan	kosalya
kamal	kamna
kamala	kamana
kamaldeep	kuldeep
kamaljeet	pamjeet
kamalkishore	kamta
kamil	kamni
kamla	kmla
kamlesh	vimlesh
kamleshwar	kaushar
kamraan	sama
kamre	kumare
kamruddin	karina
kamrudeen	samreen
kanahiya	nathiya
kanchi	kanchi
kanda	kanya
kanhaiya	kanchaniya
kanhaiyalal	najiya
kanhaya	kaushalya
kanheya	sandhya
kanhiya	kanika
kanhyalal	nehal
kanishakraj	manisa
kanisk	kanki
kanok	santok
kanta	premkanta
kantil	kanti
kanwar	rinukanwr
kapiil	kaamini
kapil	kafia
kaptan	ekata
karamvir	kushamvir
karan	rajkaranta
karandeep	swaranjeet
karansingh	rajni
karanveer	nanveet
kareshan	karshana
karim	karisma
karishan	krishka
karmbir	gambhir
karmveer	parveen
karnesh	kuntesh
kartar	kartika
kartik	barti
karunakar	taruna
kashi	minkashi
kashiram	kushi
kashish	kelashi
kashiv	sashi
kashmir	kushmi
kasid	rasida
kasim	nasima
katwa	kavita
kausal	kaushal
kaushal	koshal
kaushar	kusham
kaushik	khushi
kauslender	kuso
kauva	ladakunvar
kaval	kalavati
kavilash	savia
kavit	kawita
kawa	dayawati
kawaljeet	beeti
kayamuddin	yamini
kayum	kasumbi
kedarmal	kesar
kedarnath	keta
kesav	kesavi
kesha	keshanti
keshar	rukshar
keshav	eshavarya
keshave	kehkasha
keshram	reshama
keshri	meenakshi
kesri	kasturi
ketan	kbeta
keval	kajol
kewal	komal
khadak	nikhad
khairti	kiriti
khajan	sajan
khalid	pakhali
khalidur	koyali
khalil	sunarkali
khamchand	kanchn
khangara	roshanara
kheem	shreemati
khemchand	hemuna
khemraj	mema
khetra	seta
khimanand	khima
khokan	moka
khubchand	khushnudi
khubi	khusbu
khuma	khumlo
khursheed	khurshida
khurshid	khush
khursid	mursida
khusaboo	khusboo
khusbu	khushbu
khushal	kushma
khushi	khushnuma
khushnaseeb	naseeba
kifayat	kinya
kimat	kishmat
kingkar	minka
kiran	kiranti
kirashan	krashana
kirodimal	magla
kirorimal	mallo
kirpa	kripya
kirshan	kishna
kirshanpal	sahana
kirshn	krashna
kirshna	krishna
kirti	kitti
kirtiman	kriti
kisan	rucksana
kishan	krishma
kishn	krishama
kishnaram	sahnara
kishor	wilkish
kishore	rema
kisori	sosri
klash	lashma
kmles	tiwankle
knheyalal	lavli
kohinoor	noori
kokil	kokila
komal	koyal
koshalya	koshalya
kouchu	kushbu
koushik	kushmita
kripal	tripta
krisana	rihana
krish	rishma
krishan	raishma
krishana	rukshana
krishen	rashni
krishn	roshni
krishna	varisha
krishnal	sahna
kudeep	kureja
kulbhushan	husna
kulbir	kulli
kuldeel	leela
kuldeep	alseepa
kulli	kulina
kulwant	kalawati
kulwinder	mulina
kumail	kumari
kumar	minakumari
kumari	rajkumari
kumod	umda
kumresh	umesha
kunal	skunatla
kunda	shkundla
kundan	nano
kunden	sunena
kundin	muni
kunj	shakun
kunod	husno
kunwar	shakuna
kuparth	paro
kurban	kranti
kush	kushum
kushal	rushali
kusumakar	kusum
kuwar	rajkumaree
kuwarjeet	surjeet
laddha	araddhna
laka	gulkasha
lakh	lakhbir
lakhami	lakhmi
lakhamichand	lakhsmi
lakhan	salmakhatun
lakhi	lakhi
lakhmi	lakshmi
lakhraj	fakiha
lakhu	lambhu
lakhua	saku
lakhvinder	rakhi
lakhwinder	lakhihadar
lakki	lilaki
lakky	kosylaya
laksh	gulfasha
lakshay	laskshita
lakshaya	satya
lakshit	shakshi
lakshman	shima
lakshmi	rashmi
lakshy	kamakshya
lakshya	koshlya
lal	lalidavi
lala	laltia
lalan	alapna
lalaram	aparna
laldhari	aruni
lali	yukilal
lalit	laltes
lalital	laxita
laliya	swaliya
lallu	lalutha
laltha	kushumlata
lalu	phalguni
lamani	phoolmani
lasar	gulwasha
lateef	gaytree
latesh	natasha
latoor	kastoori
latur	kusumlata
laukush	naushi
lavkush	vikshi
lavtar	pushplata
lawli	pallawi
lawrence	lavpreet
laxman	laxmi
laxmanram	mariam
laxmi	laxami
laxmikant	luxmi
laxminarain	mina
leela	leelawati
leelu	neelu
lehru	mehru
lekhraj	julekha
lekhram	sulekha
lekose	sema
leo	sharinimle
libin	feflibai
lilaram	lilabai
lilu	liladevi
liveri	triveni
liyakat	priyaka
lllllllllllllllllll	killo
lok	bilke
lokender	leena
lokendra	nirja
lokesh	yogeshwari
lokindra	nirma
lovly	dolley
lucki	ruckmani
lukkad	mahlikka
lukman	mukiman
luv	putulu
maan	maanmati
maansingh	mansa
maatwar	maaya
madan	madina
madanlal	manali
madhan	madhuni
madharam	madhu
madho	madhvi
madhu	madhwi
madhusudan	sudha
magat	maalti
mager	maigo
maha	tajmaha
mahabir	mahjabi
mahadev	mahak
mahak	mehak
mahammd	mahima
mahasingh	mahzbin
mahaveer	mehar
mahavir	mansavi
mahbir	maahi
mahboob	majoo
mahbub	mahrul
mahendar	sahenaj
mahender	menadevi
mahendra	manorma
mahesh	mashli
mahfooj	mehfooj
mahfooz	manfool
mahfuj	shahgujta
mahinder	maina
mahindra	nahid
mahinudin	rainu
mahipal	samaiali
mahkar	manka
mahnatha	anayatha
mahraj	marya
mahroj	roji
mahtab	mamta
mahud	manju
mahveer	samaprveen
maisan	afsana
majid	majida
majunew	manwi
makan	mainka
makbul	majrula
makhan	malika
makrud	marium
maksood	jasoda
maksud	masum
malchand	mamtha
mali	ismaliye
malkeet	maneeta
malkiat	mallika
maman	mamanbai
mamata	mammta
mamchand	mem
mamraj	mamuna
mamta	mamoita
mamu	mamuni
manak	manbai
manash	mantasha
manav	manvi
mandan	bandani
mandeep	manmeet
mandu	mandvi
maneesh	sumnesh
manender	manno
manesh	manjusha
mangal	mangla
mangat	manti
mangelal	neela
mangeram	ratmo
mangeshwar	shayra
mangi	mangubai
mangilal	nagia
mangla	manimegla
mangol	manjoo
mangta	manita
mangu	manjula
mani	rukmani
manikchand	nikhat
maninder	moni
maniram	mariyam
manish	mnisha
manisha	danista
manit	mamini
manjar	najara
manjeet	manpreet
manjesh	saneha
manjit	ranjita
manjiv	anjli
manju	ranju
manku	ramjanki
manmath	panmati
manmeet	jasmeet
manmohan	mona
manni	munni
mannu	tannu
mannulal	nanu
manohar	mandothi
manoish	manoti
manoj	sanoj
manojkumar	marti
manosh	sanoshi
manowar	nosar
manphool	phool
manpreet	reeta
mansharam	sanha
manshi	marshilah
mansoor	noorin
mansur	masuma
mantosh	santosh
mantu	montu
manu	samman
manuvar	monu
manvendra	ravena
manver	tanvir
manvir	mairi
maqsood	yasoda
maryam	mariya
masheen	sheenu
masoom	soam
mastan	sita
mata	nazmaa
matadeen	aafreen
matbar	mabiya
mathura	mithu
matok	bato
maujim	mayuri
maushid	murshida
mayak	foolmaya
mayank	maryana
mayur	begumpur
mazhar	mazida
meena	meenat
meenaz	mehnaz
meenu	meeno
meer	farmeena
meera	meela
meeta	nameeta
megh	megha
meghanath	rehana
megharaj	mhega
megharam	rupam
meghashayam	shayma
meghu	meethu
megraaj	mehnaj
mehak	menakshi
mehandi	mholani
meharban	sehran
meharuddin	mehrunisha
mehbob	mehronisha
mehboob	khushboo
mehib	mehvish
mehinder	mohini
mehphal	sehjal
mehraj	sehnaj
mehruddin	rubina
mehtab	hemleta
menpal	menka
mesak	parmeswari
methun	meetu
metily	mairy
mhendar	mohseena
mho	premo
mhoomad	roma
mhosin	mohsina
michael	mitali
midda	amida
miha	amritha
mihir	mithi
mikel	milka
milan	sharmila
milap	ramila
milkhi	minakshi
mintu	sintu
miraz	miraz
mishri	moshri
mishrilaal	shaila
misri	minaksi
mithelash	englas
mithilesh	niti
mithlesh	sithal
mithu	asmit
mithun	momin
mitlesh	misbah
mitnu	philomina
mitthu	sattu
mitthun	munia
mittopuri	manpritkour
mnoj	munjira
mnyak	nayaka
mobarkar	soba
mobin	momina
modh	sumedha
mogan	mony
mogli	mooli
moh	shymo
mohabbat	baita
mohad	monam
mohak	moona
moham	mosam
mohamad	chapma
mohammad	shamima
mohan	sohani
mohanlal	chancal
mohanram	shahnam
mohar	mukhtyar
moharan	marjana
mohardi	morki
mohatter	bhteri
mohd	smshida
mohhmad	momena
mohini	monini
mohinuddin	rohini
mohit	momita
mohmad	soma
mohmed	umme
mohmmad	tohmeena
mohmmd	mosmi
mohsin	nosi
moin	najmin
moinuddin	sonu
mokida	monika
molu	mousam
momin	somi
mona	jasmina
moni	monti
monish	noni
monti	konti
montu	monny
monty	sony
monu	munmun
monupal	sonal
mookan	muskan
mool	amrooti
moolchand	phoola
moolchul	phuli
mooldan	nootan
moshad	shadna
moshin	roshini
mosim	muslima
moti	jayoti
motilaal	similata
motilal	rohila
motolal	phoolla
mousin	musmi
mrityunjay	prity
mubarik	mudrika
mubashir	urwashi
mudasar	mudsay
mudbir	rubi
mudsir	musra
mudssir	musrat
muhmad	suma
mujaffar	sujata
mujeeb	jebi
mujibu	munbura
mujmmil	ujamma
mukaram	muskarn
mukat	mukti
mukeemuddin	sameem
mukesh	mehwish
mukhtar	rukhsar
mukhtiyar	rukiya
mukhtyar	rukya
mukish	mustki
mukkesh	mushkan
mukram	murjina
muksndi	soni
mukul	amarmula
mukund	munnadevi
mul	bulbul
mula	nirmla
multan	nutan
mumtaj	mumtaj
munajir	najira
munder	muntrin
muneer	puneeta
munender	munna
munesh	kamrulnisha
munish	munnia
munkad	yamuna
munna	munny
munnakumar	ugma
munnawar	sna
munne	punni
munnem	tarunnam
munni	unnati
munnu	rennu
munshi	nshima
munsi	murti
muntajar	najma
muntiyaj	sniya
muntjar	teja
muqhtar	mumtaz
murad	smradhi
murari	shivkumari
murarilal	rahila
murli	murtibai
mushir	shipra
mushrraf	musarrat
musibat	siza
muskan	rusan
muskuran	sakura
muslim	salima
mustafa	safali
mustak	taki
mustaq	gulista
mustikeem	neema
mustkeem	seema
mustkim	ramsati
muzamiil	uzma
muzim	rimzim
muzmil	urmila
naajim	naima
nabal	nabila
nabav	narbda
nabi	zainab
nabijan	najrana
nadaim	nandani
nadeem	naseema
nadem	shabanam
nadhim	nashima
nadim	nandini
naeem	neemi
nafe	nafeesa
nagaji	nagma
nagender	nagina
nagendra	nandita
nahar	neaha
nahid	nahida
naim	poonam
naimuddin	nazmin
nain	sunaina
naina	naina
naisi	nafisa
naitik	nitika
najar	najarana
najim	najni
najimuddin	najo
najis	najrin
najre	najreen
najrin	nasrin
najubai	nurbi
nakched	nachita
nakul	sakuntla
naman	nazma
nanagram	nayna
nanak	nanki
nand	gulnanj
nandi	nahani
nandita	vandita
nandkishore	ranki
nandram	narayn
nandu	anzum
nanhe	saranthem
nanhey	nancy
nanhu	panchuri
nanka	anuska
nankesh	ntasha
nanku	shankuntla
nanni	nazani
nannu	annpurna
nanu	anupriya
nar	naraini
narain	nashrin
narander	narbada
narayan	nayana
narbahadur	rahat
narbir	robi
narendar	reena
narender	nasreen
narendera	nasreema
narendra	narmda
naresh	wareesha
nareshpal	varsha
narhasi	parsi
narinder	rini
naroo	arzoo
narpendra	fareeda
narsa	nursa
narsingh	nassin
naruram	nazira
naryan	nazrana
nasar	sheensar
naseef	naveeda
naseem	neelam
nashim	rashimi
nashimuddin	shilu
nasiar	nazia
nasim	tasnim
nasir	priyansi
nasruddin	ruksin
nasrudeen	nazreen
nasrul	serul
natha	namita
nathani	ratani
nathu	fooljhnah
nathulal	rahul
nathuram	nitam
natthu	neetu
naulakh	naveela
naulesh	tulsha
nausad	nusrat
naushad	nitasha
navdeep	naveena
naved	navleen
naveen	navneet
navendra	raveena
navi	navita
navin	vashanavi
navjoot	rajjoo
navneet	nazneen
navnit	vinit
nawab	shahnawaj
nawal	sanaali
nawaz	farhanaaz
nawed	saweta
nayan	naviya
nayeem	poneem
nazeem	neelima
nazim	naziya
nazir	sazi
nazirul	nirjla
nazmuslam	seelam
neelajan	lajja
neelkant	neeli
neeraj	neeta
neeshu	incee
neetu	neeti
neeven	noreen
nej	benjir
nek	nekki
neki	nikita
nenhe	nency
nepal	nelam
nesha	sneha
netra	sumentra
netram	santra
netrapal	satyapal
newal	neelachal
nidhi	sidhi
nihal	nirmal
nihalchand	nicharon
nijam	nipam
nijamuddin	nimla
nijamudeen	peena
nikhil	nikil
nikhleshwar	khshbu
nikita	niksiya
nila	nilofar
nilu	nirutma
nimahe	antima
nimesh	nirosha
nipun	nini
niraj	nirvat
niranjan	ranjana
nirbhay	nibo
nirmal	nirmala
nirmaljeet	nirwat
nisar	nisat
nischaya	chhaya
nisha	nishtha
nishal	vishal
nishant	nikahat
nishith	shgita
nishu	novisha
nitesh	sntosh
nithyanandham	aardhna
nitin	valentina
nitish	nuraish
nittin	parniti
nitu	minitwa
niwas	bironica
niyaaz	virjiniya
nizam	antim
nizamuddin	nimmy
njare	parem
noor	nooreen
noora	noorpa
nooralam	noomi
nooralha	nurjaha
noore	norti
noori	bhoori
noorjama	pooja
noornabi	soona
nooruddin	ruzina
nootan	phoolwanti
nosad	kosar
noshad	roshani
nrendr	reenu
nrotam	roopam
numesh	sudershan
nur	sabnur
nwed	waheeda
ojas	saroja
oli	phooli
ombeer	rojmeri
ombir	roobi
omender	rojmen
omendra	rawi
omesh	santoshi
omeshkumar	shuman
omi	promila
omjone	soonam
omkar	kachri
ompal	ompati
omparkash	rashma
omparkesh	reshmi
omparsad	varsa
omperkash	awshin
omprakash	pratiksha
omprakesh	priyak
omprkash	prabhu
omprkesh	prem
omveer	veermati
opendar	preena
ovaish	vaishali
pabitra	pavitra
pabu	prabhila
pachuram	panchma
padam	pammi
pahalwan	pholwanti
palaram	payana
pallu	pallvi
panaj	spana
pancham	panchi
panchhi	prachi
panchi	panchoo
panchuram	aanchal
pancu	pawni
pandit	pangita
pandu	peenu
pankaj	parinka
pankajsheel	sheelu
pankuj	pinku
panna	sanna
pannalal	alima
pannu	tarannum
papp	chappla
pappe	papiya
pappu	anupuma
papuu	anusuiya
param	prameela
paramjeet	pareeti
paramjit	parmita
paramveer	praveen
parash	sarah
parashram	darfasha
parashu	patasi
parathvi	pargati
paratibha	partibha
parbhat	parvati
parbhu	prabhjot
parbhudayal	rabhida
pardeep	parveena
pardep	parven
pardeshi	shabi
pardhuman	parmila
pareen	sareen
parem	prema
pargat	parwati
parhalad	pharjana
pari	pariti
parjinder	pyari
parkash	shakashi
parlad	premla
parmanand	parsann
parmeshwar	sarshwati
parminder	premi
parmjeet	preeti
parmo	partima
parmod	narmada
parmodh	yasodha
parmood	afrooj
parnav	parerna
parsanjeet	sanjeeta
parsant	prasanta
parshant	bashanti
parshotam	tamsa
parshu	vipasha
parsnath	upasna
parsuram	purva
partab	armita
partap	parvti
parteek	prete
parth	pratibha
partik	pritika
partul	sahrul
partyush	pataso
parveen	praveena
parvej	piroj
parven	farheen
parvesh	avastha
parvez	prezi
parvinder	rvina
pasanjeet	sangeet
patan	satwanti
patav	satyavati
patender	prati
patras	taitra
patric	gaitri
paul	pallavi
pavan	avantika
pavnesh	saeshta
pawan	rawana
pawansingh	sawana
pawna	apsana
peentu	reetu
pemaram	premlata
penzin	zina
pera	prableen
perdeep	preety
perkash	prinka
permeshwar	reshami
perveen	veena
pervez	rachpreet
pervinder	vineta
phakir	shakti
phirdos	firdosh
phool	phoolwati
phooleshwar	pholwati
phoolo	pooga
phoolwati	foolwati
pinki	pinki
pinkoo	pinky
pinku	rinku
pinttu	punit
pintu	rinju
pitar	pitika
piuesh	pushpa
piyus	priya
piyush	puspha
pokhar	poga
poma	omwati
pooja	poornima
poonam	sonam
pooran	foranta
pooranmal	rajna
popinder	pinkey
poshetty	shelly
pphola	phulkana
prabhakar	rambha
prabhash	pritibha
prabhat	pragati
prabhatilal	pramila
prabhatyashi	yashika
prabhjeet	rajeena
prabhjit	rabita
prabhu	rahnuma
prabhudayal	rashida
pradeep	rakeeba
pradep	ramdevi
prafhool	afroz
praful	fulo
prahlad	rachna
prakash	pryanka
prakesh	revakshi
prakul	preyank
pramal	pratima
pramatma	fatma
prameshwar	ramwati
prami	pragti
pramjeet	preti
pramjot	rajanti
pramod	ramdulari
pramood	tranoom
prankur	piryanka
prannab	ranjna
pransis	pryanika
prasant	upasana
prashanat	afshana
prashansa	shahna
prashant	santa
pratap	ratna
prateek	reekha
pratha	radhab
pratul	premwati
praveen	saveena
pravendra	vandna
pravesh	rashika
pravin	ragina
pravindra	rahina
prayatan	rafat
prdeep	sukhpreeet
preet	sunpreet
preetam	reetima
preeti	reeti
prem	premawati
premchand	prwem
premnarayan	reema
prempal	gurmala
premsingh	nemsi
preyojit	yogita
prhalad	pushapa
priju	sarju
prinsh	prinkya
pritam	srita
pritesh	srishty
prithvi	smriti
priti	sharjprit
prittam	pulita
priyansu	priyanka
prkesh	rukshan
prmod	pirmika
prsant	rosan
prshant	pushpan
pujja	pujadevi
pukharam	sunhara
pulkit	fulki
punarjyoti	jotyi
puneet	suneeta
punia	punita
punit	sunita
punkaj	priynka
puran	nusrant
puranmal	purnima
purnmal	gurmel
pusgpender	puspa
pushank	shankri
pushkar	vishavkarma
pushpa	pushpawati
pushpender	sushree
pushpendr	sapna
pushpendra	ruhhena
puskar	ruksar
puspak	ruppa
puspendar	sundari
puspender	huseni
puswa	susma
pyar	supyar
pyare	piyari
pyarelal	sarmeela
rabpreet	sabreen
rada	razida
radat	radhabai
radesyam	resmi
radha	radhika
radhamohan	sharadhha
radhe	radikha
radhesayam	sayda
radheshyam	sabhya
radhey	rajshree
radheyshyam	shamim
radhyshyam	shampa
raeeyan	rangeeta
rafal	shaifali
rafeddin	rafikan
rafi	aafrin
rafiq	rajia
raghav	sarjaha
raghbir	rajbiri
raghu	ragini
raghubeer	rubeena
raghubir	rubbi
raghunandan	sandna
raghuveer	veenu
raghuvir	ravita
ragib	ratni
ragwender	twenkle
raheesh	sabeeha
rahil	takshila
rahim	raismi
rahimuddin	saimun
rahis	sahishta
rahish	sahistha
rahishudeen	tahseen
rahisuddin	siddhi
rahmat	rampati
rahu	raunaf
rahul	kherul
rai	suraiya
raisingh	rajina
raisuddin	razia
raj	rajiya
raja	richaraj
rajam	rajlaxmi
rajan	rajwanti
rajaram	rajkarnta
rajat	rajwati
rajbeer	sabeena
rajbir	rabiya
rajdev	saridevi
rajdut	sajda
rajeet	sujeet
rajeev	sajmeen
rajend	ranjnika
rajendar	ranita
rajender	razni
rajendra	raniya
rajesh	urvarshi
rajeshvr	shiva
rajibul	rajkali
rajider	sajida
rajinder	sajini
rajish	samiksha
rajit	sagit
rajiv	sajia
rajjit	sajni
rajkiran	sakiran
rajkumar	sajma
rajkumarm	kumkum
rajmani	ramaiya
rajna	sajana
rajneesh	sahab
rajnesh	tanushri
rajni	foranti
rajnish	tajrani
rajo	sanjoh
rajpal	ramkali
rajputra	udita
raju	sartaj
rajuddin	sanju
rajveer	saveroon
rajvi	ramvati
rajvir	savitri
rakesh	ronak
rakhi	priyaki
rakho	rukhsona
rakkibhul	kooki
rakshit	asmita
rama	taramati
ramakant	ramkanya
raman	tamana
ramanand	tamanna
ramavtar	rampayari
rambabu	ramrati
rambarose	rooshi
rambhajan	rubjaan
rambharos	rosina
rambhool	sabbo
rambhul	phulbi
rambir	samiron
rambrij	sabrin
ramchander	saima
ramchandr	salma
ramchandra	sandya
ramdas	samsida
ramdev	somdevi
ramdhan	sadhana
ramdhin	farhin
ramdin	samina
ramdutt	sampat
ramdyal	raziya
rame	laxmeena
rameh	shamshina
ramender	umedi
ramesh	mishbha
rameshwar	rekhwan
rameshwer	sweta
rameswar	saroj
ramfare	ruksaar
ramgopal	roopali
ramhetu	revti
ramjan	sanjan
ramjanam	rijwana
ramjani	sarojani
ramjeet	sameena
ramji	rimjhim
ramjiyawan	sajiya
ramkaran	saanu
ramkesh	samiksa
ramkhilawan	sarmila
ramkiashan	shahin
ramkish	reemi
ramkishan	shaina
ramkumar	kusuma
ramkumari	smarti
ramlakhan	rosanjahan
ramlal	malti
rammurti	surti
ramnath	shanah
ramnihor	salmi
ramniwas	sania
ramniwasj	samima
ramotar	hasmita
rampaal	sapana
rampal	rimpi
rampati	rehmati
ramphal	chanchala
rampher	sarangthem
ramprasad	sadhna
ramsagar	sayari
ramsawroop	roopa
ramsem	pammy
ramsewak	saraswati
ramsingh	samrin
ramsurat	sarasvati
ramswaroop	santro
ramswroop	rozi
ramswrup	rupi
ramtek	rekha
ramu	subhadra
ramulu	saalu
ramveer	yasmeen
ramvihar	vibha
ramvilash	vimla
ramvir	shyamvati
ramwatar	swata
rana	sagiran
ranbir	ruanbza
randeep	sangeena
randheer	shaheen
randhir	tahira
rani	shimran
ranjan	sanjana
ranjay	sanjna
ranjeet	sangeeta
ranjit	sanita
ranju	trannum
ranpal	rizvana
rantesh	vanshika
ranveer	tanvi
ranvir	shavitri
rasab	hafsa
raseel	seetal
rashab	shabbo
rashid	lahida
rasid	sahida
raspal	salni
rasul	sujli
ratan	shrabani
rathan	sabhana
rati	srimati
ratikant	rinka
ratiman	sahima
ratn	simran
ratnesh	santna
ratneshwar	sayra
ratneswar	swati
ratul	santu
ratwari	sawariya
raud	subhdra
rauf	sagufta
raveena	sakeena
ravi	ladidavi
ravidutt	savita
ravikant	malvika
ravinath	vinna
ravindar	vidya
ravinder	savrin
ravindera	satvida
ravindr	shravani
ravindra	aalina
raviraj	saviha
ravishankar	shanaz
rayish	gaytri
razi	marzina
razim	fazin
redhema	ridhima
reena	zareena
reenu	renuka
rehaan	sehnaaz
rehan	surekha
rehman	tehmina
rehmat	hemlata
rejaul	sejan
rekha	seekha
rekhai	rukhsna
repu	trepti
revndrshing	saahin
reyaz	kosaleya
rghuraj	gulsan
ridhakaran	vidhya
rihaan	rizwana
rihal	sikha
rihan	rukhsana
rijakpal	vijaya
rijul	sharmili
rijvan	sivani
rijwan	shiwani
rima	shrimati
rinka	prinkaya
rinkal	pryinka
rinki	rinki
rinkoo	rinky
rinku	tinki
rishab	siksha
rishabh	shobha
rishaw	sarsawati
rishi	shiba
rishipal	silpa
rishiraj	sipra
rishu	shruti
risiraj	sirjna
ritesh	sarita
rithik	gitika
ritik	suriti
ritu	sarwitavm
ritunjay	afrina
rituraj	sukrita
riyajuddin	rubiya
riyajudhin	husina
riyajudin	runiya
riyajul	seeriya
riyasat	vidyawati
riyaz	supiriya
riyazuddin	rozina
rizwaan	virwanti
rizwan	firoza
rma	sumemtra
robert	groti
rohaan	shabanm
rohan	sobha
rohil	sohni
rohit	farhib
rohitash	shital
rohtash	tasbiha
rohthash	subhi
roji	sarojini
rolly	rozy
ronak	sonaki
rony	soniya
rookmani	somanti
roop	rubo
roopnarayan	sayana
roopsingh	sabina
roshan	sosan
roshanlal	shayna
rsjesh	sehnaz
rubal	rubbina
ruben	rubey
ruchendra	ruchika
ruchit	suchita
rudhra	sudhama
rudmal	sudma
rudra	varda
rukhsar	ruksana
ruksar	sukshana
rukshan	gulshana
rumeet	beeuty
rup	rubby
rupak	supna
rupan	utpana
rupen	tarun
rupender	simren
rupendra	zenab
rupesh	sushma
rupinder	suneta
ruplal	tulsa
rustam	sushama
rvindra	vinita
saad	sayada
saahil	sabila
sabana	sabana
sabbab	sabna
sabbir	bebi
sabbu	shabbenour
sabeer	sayeri
sabi	sabita
sabid	sabiya
sabir	sabrina
sablu	salupa
sabrajeet	savreen
sachi	suchi
sachidanand	shahida
sachin	sahina
sadab	sandiya
sadabrij	sarbari
saddam	sabnam
saddham	shadhna
saddiq	sahjadi
sadhna	shadhana
sadik	safika
sadip	shadiya
sadiq	shahjadi
sadod	sanno
sadre	sarika
sadur	shabnur
saeed	shakeena
safiq	safila
sagan	saaniya
sagar	sagrika
sagir	sangita
sahab	sahiba
sahabbudin	shabina
sahabudeen	sahnaz
sahadeb	sahajha
sahajad	sahanaj
sahajaha	shanjhan
sahbaj	shahiba
sahbuddin	shahina
sahdab	sahista
sahdev	sukhdevi
saheb	shekiba
sahi	safina
sahid	shahista
sahil	shaili
sahjad	sayja
sahkir	sakina
sahlesh	shulekha
sahna	shahnaj
sahnabaj	sayna
sahnaj	shahnaz
sahnawaz	shehnaz
sahnaz	sibanaz
sahrik	sawtri
sahrukh	shikha
sahun	sauni
sahwaj	sawati
sai	saiesta
saidas	sanjida
saidul	saifali
saieman	ilema
saif	saista
sainky	salina
saizad	sazia
sajan	snjana
sajid	santi
sajjan	sabanam
sajju	lajjavati
sajruddin	shamrin
sakal	shakutal
sakcham	shivam
sakchan	shbana
saket	saveta
sakhichander	sunaki
sakib	shakina
sakil	vakila
sakir	sawitri
saksham	shamina
salaman	sayma
salauddin	salini
saleem	salomi
salesh	sital
salim	saloni
salin	shalini
salinder	sazmin
salmaan	samiya
salmam	sudama
salman	shabila
sam	tapsam
samad	jyotsana
samadh	sazya
samadhan	vandhana
samar	sawatri
samay	simmy
samayddin	shyamwati
sambhu	surbhi
sameem	seeba
sameer	selars
sameeruddin	guddiya
samer	sosari
samim	simmi
samina	tasmina
samir	sumirta
samit	sapita
sammiuddin	somil
samon	sonia
sampat	somwati
samser	susri
samsuddin	sunil
samsudin	yasmin
samsung	sangeta
sanand	saniya
sanat	dhanwati
sanaullah	sakuntala
sanavvar	dvndavva
sanchit	saviti
sandeep	sngeeta
sandhaya	shayana
sandip	shvani
sangeeta	seweta
sangit	shivangi
sangram	anamika
sanjai	shyani
sanjay	tanuja
sanjeet	sweeti
sanjeev	subani
sanjeevan	gulsana
sanjey	sukanya
sanjit	suhani
sanjiv	shivani
sanju	tarnum
sanjya	saziya
sankar	sonika
sankarlal	shakuntala
sanni	suganti
sanny	sonyi
sanoj	sumanlta
sanpat	kesnata
sansaar	anusoya
sant	sujanti
santi	suntia
santosh	senthia
santram	shakuntla
santrm	sukhwanti
santu	suzata
sanu	sugandb
sanwar	sunarki
sapan	shilap
sapna	sugna
sarabjeet	sarswati
sarad	zahira
sarafat	tarawati
sarafraj	zarina
sarain	marjina
saranjeet	zeenat
sarbash	tabasum
sarbjeet	sweety
sardar	gulsida
sardeep	shushree
sardhu	shumita
sarfaraj	shagufta
sarfraj	shailja
sarif	smariti
sarik	swagtika
sarip	silpi
sariq	sefali
sarita	sumita
sarjeet	sheetal
sarju	surjiya
sarkar	shivalika
saroj	bakhtvaar
saroop	sozi
saroz	fozia
sartaj	sudhata
sarthak	swetha
saruf	sufiya
sarvan	hemavanti
sarvash	satyvati
sarves	shveta
sarvesh	veshali
sarvjeet	vijeta
sarwan	sukmani
sashi	sushri
satan	snehlata
satayanarayan	tayab
satbar	vijayanta
satbir	sukhbir
sateesh	shiteel
satender	vedehi
satendra	sukenta
satish	sisty
satnam	swetna
satnarayan	katyayani
satnosh	chanchl
satpal	shetal
satrohan	sumitra
satrudan	tumpa
satrughan	uganti
sattaram	kusumlatta
satu	kulsum
satveer	sukhvir
satvir	switi
satya	sutiya
satyadev	sunayna
satyam	nayamati
satyanara	tania
satyanarayan	tamnna
satyapal	joyaa
satyaprakash	tapsya
satyawan	suhaliya
satyender	vyelet
satynarayan	yashmin
satyvrat	zoya
saud	tabbsum
sauhal	sunali
saurab	shqakuntla
saurabh	subhagi
saurav	kushumavati
savan	lilavati
savir	silvia
sawali	sonali
sawan	vaijanti
sawarmal	sumaila
sawrn	tarnnum
sazid	vesali
schin	shobina
sedarath	vidhavati
seeta	geetika
sehbaj	shneha
sehboob	shoiba
sehdev	shmejha
sehin	suhagini
sehjamal	kelama
sehjan	subhangi
sehnawaj	shkuntala
sehzad	shilpa
sehzada	yashoda
sekha	sukheeya
selva	sushela
senser	susheela
sethi	shilly
seti	tulasi
sevak	shefali
shabbir	shifali
shabi	gulshtab
shabir	shilpi
shaboob	shimla
shabuddin	fuljhadi
shadab	shittal
shadan	shushma
shadhik	shushila
shadik	mallik
shafi	shimpi
shafibul	tulki
shagufta	susmita
shahabuddin	dipti
shahbaz	gulnaaz
shahboob	shusila
shahbuddin	chumki
shahib	sushhmita
shahid	subhiya
shahir	sumalia
shahjad	sunitha
shahnabaz	vandhna
shahnawaj	sulochna
shahnawaz	taniya
shahnwaj	sushila
shahruf	suhsmita
shahrukh	jhumki
shahvaj	sushmita
shahwaj	yashodha
shahzad	husiya
shaid	guddibai
shaikh	baikunthi
shail	susila
shailash	bilkis
shailender	zhini
shailesh	simpi
shaitan	yinita
shajid	tanjima
shakar	tashkkur
shakhtnsana	vicakha
shakib	minakxi
shakil	twinkil
shakir	tulsi
shakti	jayotli
shalender	koslya
shalid	taslima
shalig	lilima
shambhu	bhumika
shambu	begam
shami	tavvasum
shamim	minaxi
shamshad	tabsum
shamsher	vasiya
shamshudin	kiniya
shamsuddin	minaxni
shan	nazahat
shanawaz	vimala
shanbhu	tabbwum
shani	vijaynti
shankar	konika
shankarlal	tiwnkal
shanker	nikky
shanshak	supriya
shanti	gytri
shanu	tabassum
shanvaj	vijayta
shanwaj	joyti
shanwaz	fornta
sharad	tripti
sharanjeet	vineeta
sharat	jyoty
sharda	felicia
shardanand	gungun
shardha	meenaxi
sharee	rebecca
sharib	vikki
sharukh	tabssum
sharwan	tabwsum
shashai	vivek
shashank	twinkal
shashi	tapsyum
shashid	veejita
shashikant	veronika
shashwat	veenita
shaswat	vironika
singh kaur
vivekananda vedika